{
  "levels": [
    {
      "name": "Level 1: Simple Path",
      "start": { "x": 1, "y": 1 },
      "grid": [
        [1, 1, 1, 1, 1, 1, 1, 1, 1, 1],
        [1, 0, 0, 0, 1, 0, 0, 0, 0, 1],
        [1, 0, 1, 0, 1, 0, 1, 1, 0, 1],
        [1, 0, 1, 0, 0, 0, 0, 0, 0, 1],
        [1, 0, 1, 1, 1, 1, 1, 1, 0, 1],
        [1, 0, 0, 0, 0, 0, 0, 0, 0, 1],
        [1, 1, 1, 1, 1, 1, 1, 1, 2, 1],
        [1, 1, 1, 1, 1, 1, 1, 1, 1, 1]
      ]
    },
    {
      "name": "Level 2: The Maze",
      "start": { "x": 1, "y": 1 },
      "grid": [
        [1, 1, 1, 1, 1, 1, 1, 1, 1, 1, 1, 1],
        [1, 0, 0, 0, 1, 0, 0, 0, 0, 0, 0, 1],
        [1, 0, 1, 0, 1, 0, 1, 1, 1, 1, 0, 1],
        [1, 0, 1, 0, 0, 0, 0, 0, 0, 1, 0, 1],
        [1, 0, 1, 1, 1, 1, 1, 1, 0, 1, 0, 1],
        [1, 0, 0, 0, 0, 0, 0, 0, 0, 1, 0, 1],
        [1, 1, 1, 1, 1, 0, 1, 1, 1, 1, 0, 1],
        [1, 0, 0, 0, 0, 0, 0, 0, 0, 0, 0, 1],
        [1, 0, 1, 1, 1, 1, 1, 1, 1, 1, 2, 1],
        [1, 1, 1, 1, 1, 1, 1, 1, 1, 1, 1, 1]
      ]
    },
    {
      "name": "Level 3: Victory!",
      "start": { "x": 1, "y": 1 },
      "grid": [
        [1, 1, 1, 1, 1, 1, 1, 1],
        [1, 0, 0, 0, 0, 0, 0, 1],
        [1, 0, 1, 0, 0, 1, 0, 1],
        [1, 0, 0, 0, 0, 0, 0, 1],
        [1, 0, 1, 0, 0, 1, 0, 1],
        [1, 0, 0, 0, 0, 0, 2, 1],
        [1, 1, 1, 1, 1, 1, 1, 1]
      ]
    }
  ]
}
